13 27

|_________________________|
|P.........|.P.|.........P|
|..___..|_...|..._|..___..|
|...|P................|...|
|_..|_....._..._....._|.._|
|..........|.F.|.......P..|
|...|.......F.F.......|...|
|P.........|F.F|....,.....|
|...|_....._.F._....._|...|
|...|.................|...|
|..___..|_P..|..._|..___..|
|P.........|...|....@....P|
|_________________________|

